1111111111111111111111111
100001P000100000000000001
101C0101101000C0000C00001
1011110000111111111100111
100C000C1C1100100000001C1
111111111010C010000000001
11C000000010001C10100C001
11111111011000001010C0C01
10000000000000001C100C001
10C00000000000C01C100C001
10000001111000001C110E011
100000C111C000001C1100011
1111111111111111111111111