1111111111111111111111111111111111
1C000010C0C000110C00000C10C0000001
1000010000000011000C0000100000C001
10000E10000000000000000P10000000C1
1C000C000C0000000C000C000000000001
1111111111111111111111111111111111